111111111111111
1E00C00010000P1
10C0000C0C00011
1010010C000C001
1000000C110C001
111111111111111
