11111111111111111111111111111
1E00C00010000000C000000C000P1
1000000C00000C000001110000011
11110000C00000C00001111100111
1110000000111100C0000C0000001
11000C0000000000C0000000000C1
11111111111111111111111111111
