1111111111111
100C000000001
10010C00000C1
1C00E11111001
1P00110000001
1C0000000C001
1111111111111