1111111111111
1000000000001
10010000000C1
1000011111001
1P00110E00001
1000000000001
1111111111111