111111111111111111111111111111111111111111111
101010000000000000000000000000000000000000001
10000C000000000000000000000000000000000000001
1100011P1100000000000000000000000000000000001
110000000000000000000000000000000000000000001
11000000E000000000000000000000000000000000001
101010000000000000000000000000000000000000001
101010000000000000000000000000000000000000001
101010000000000000000000000000000000000000001
101010000000000000000000000000000000000000001
101010000000000000000000000000000000000000001
101010000000000000000000000000000000000000001
101010000000000000000000000000000000000000001
101010000000000000000000000000000000000000001
111111111111111111111111111111111111111111111