1111111111111
1E000C0P00001
1111111111111