1111111111111111
1000000011000001
11100000000000P1
10000E0000000001
1111111111111111