1111111111111111
1000000C11000001
111C00C00C000011
10000E0000C00C01
1111111111111111