1111111111111111
1000000C11000001
111C00C00C0000P1
10000000E0000C00C01
1111111111111111